12 12
9 9 9 9 9 9 9 9 9 9 9 9
9 0 3 3 9 0 0 5 0 0 0 9
9 0 3 0 9 3 0 0 6 0 0 9
9 0 0 0 9 3 0 5 0 0 0 9
9 0 0 0 0 3 0 0 0 0 0 9
9 0 5 0 0 0 0 0 3 0 0 9
9 0 0 5 0 0 0 0 0 0 0 9
9 0 0 0 3 0 0 0 0 0 0 9
9 0 0 0 0 0 0 5 0 0 0 9
9 0 0 3 0 0 0 0 6 0 0 9
9 6 0 0 0 0 0 0 0 0 0 9
9 9 9 9 9 9 9 9 9 9 9 9