15 15
9 9 9 9 9 9 9 9 9 9 9 9 9 9 9
9 0 0 0 9 5 0 9 0 5 0 0 0 0 9
9 0 0 0 9 0 6 9 0 0 0 0 0 0 9
9 0 0 0 9 0 9 9 0 0 0 0 0 0 9
9 0 0 9 9 3 9 0 0 0 0 0 0 0 9
9 0 0 0 0 0 9 0 0 0 0 0 0 0 9
9 0 9 9 9 0 0 0 0 0 0 0 0 0 9
9 5 5 5 5 5 5 0 0 0 0 0 0 0 9
9 5 5 5 5 5 5 0 0 0 9 9 9 9 9
9 0 0 0 0 0 0 0 0 0 0 0 0 0 9
9 0 0 0 3 0 9 0 0 6 0 0 0 0 9
9 0 0 0 0 0 9 0 0 0 0 0 0 0 9
9 0 0 0 0 0 9 6 0 0 0 0 0 0 9
9 9 9 9 9 9 9 9 9 9 9 9 9 9 9