24 22
9 9 9 9 9 9 9 9 9 9 9 9 9 9 9 9 9 9 9 9 9 9
9 0 0 0 0 0 0 0 6 0 0 9 0 0 0 0 0 0 0 0 0 9
9 0 0 9 9 9 0 0 9 0 5 9 0 0 0 9 5 0 0 0 0 9
9 0 0 9 5 0 3 0 9 0 0 9 0 0 0 9 9 9 9 0 0 9
9 0 0 9 6 0 0 0 9 0 0 9 0 6 0 0 0 0 0 3 0 9
9 0 0 9 0 0 0 0 9 3 0 9 0 0 3 0 0 9 9 9 9 9
9 0 0 0 6 9 9 9 9 9 6 0 0 0 0 0 0 0 0 0 0 9
9 0 0 0 0 9 0 0 0 0 0 0 0 9 9 9 9 9 0 0 0 9
9 0 6 9 9 9 0 3 0 9 0 0 0 9 0 0 0 9 0 0 0 9
9 0 0 9 0 0 0 0 6 9 0 0 6 9 0 0 0 9 0 0 0 9
9 0 0 9 0 0 6 9 9 9 9 0 0 9 0 0 0 9 0 0 0 9
9 0 0 9 0 0 0 0 0 9 0 0 6 9 0 0 0 0 0 0 0 9
9 0 0 9 3 0 0 3 0 0 3 0 6 9 0 3 0 0 0 6 0 9
9 0 0 9 0 0 0 0 0 0 0 0 0 9 0 0 0 0 6 0 0 9
9 0 0 0 0 0 3 0 9 9 9 0 0 9 9 9 9 9 9 9 0 9
9 0 0 0 9 0 0 0 0 5 0 0 0 9 0 0 0 9 3 0 0 9
9 0 0 0 9 0 3 0 0 0 0 0 0 9 0 0 0 9 3 0 0 9
9 0 9 9 9 0 0 0 0 0 3 0 0 9 9 0 0 9 0 0 0 9
9 0 0 0 0 0 0 9 9 9 9 0 0 0 9 0 0 0 0 9 0 9
9 0 9 0 0 0 6 0 0 0 9 0 0 0 9 0 0 0 0 0 0 9
9 0 9 9 9 0 0 0 0 0 9 0 3 0 9 9 9 9 9 9 0 9
9 0 3 5 9 0 0 9 9 9 9 6 0 0 0 0 0 0 0 9 0 9
9 0 9 9 9 0 0 0 0 0 9 0 0 0 0 6 5 0 0 9 5 9
9 9 9 9 9 9 9 9 9 9 9 9 9 9 9 9 9 9 9 9 9 9